SKE = "countries/Skellige.txt"
TEM = "countries/Temeria.txt"
RED = "countries/Redania.txt"
KAE = "countries/Kaedwen.txt"
AED = "countries/Aedirn.txt"
LYR = "countries/Lyria and Rivia.txt"
MHK = "countries/Mahakam.txt"
HEN = "countries/Hengfors League.txt"
KOV = "countries/Kovir and Poviss.txt"
BRO = "countries/Brokilon.txt"
NOV = "countries/Novigrad.txt"
CIN = "countries/Cintra.txt"
ANG = "countries/Angren.txt"
SOD = "countries/Sodden.txt"
CID = "countries/Cidaris.txt"
KER = "countries/Kerack.txt"
VER = "countries/Verden.txt"
BRU = "countries/Brugge.txt"
TOU = "countries/Toussaint.txt"
NIL = "countries/Nilfgaard.txt"
VIC = "countries/Vicovaro.txt"
ETO = "countries/Etolia.txt"
NAZ = "countries/Nazair.txt"
EBB = "countries/Ebbing.txt"
GEM = "countries/Gemmera.txt"
MCH = "countries/Maecht.txt"
MET = "countries/Metinna.txt"
GHE = "countries/Gheso.txt"
MAG = "countries/Mag Turga.txt"
ZER = "countries/Zerrikania.txt"
HAN = "countries/Hannu.txt"
BAR = "countries/Barsa.txt"
QUR = "countries/Qura.txt"
NAM = "countries/Nammu.txt"
NAR = "countries/Narayana.txt"
KIR = "countries/Kiruhk.txt"
MAD = "countries/Madahri.txt"
SIV = "countries/Siva.txt"
BAH = "countries/Bahal.txt"
HAA = "countries/Haadith.txt"
SUR = "countries/Surata.txt"
VAS = "countries/Vashik.txt"
AJR = "countries/Ajrabahl.txt"
RIY = "countries/Riyadahn.txt"

